EA ./texturas/amapolas.png
SO ./texturas/margaritas.png
WE ./texturas/pensamientos.png
NO ./texturas/rosas.png

F 40,120,60
C 100,149,237

1111111111111111111111111111111111111
1S01000000011000000000110000000001111
1011011011011011011011011011011011011
1000010000011000010000010000010000111
1111011111000001110000000011111110111
1111011111000001110000000011111111101
1000010000011000010000010000010000111
1011011011011011011011011011011011011
1001000000011001000000011001000000111
1111111111111111111111111111111111111
