EA ./texturas/amapolas.png
SO ./texturas/margaritas.png
WE ./texturas/pensamientos.png
NO ./texturas/rosas.png

F 20,100,40
C 20,20,100

11111111111
10000000001
10000000001
10000000001
10000000001
10000N00001
10000000001
10000000001
10000000001
10000000001
11111111111