NO /Users/marirodr/cursus/cub3d/textures/Brick_02-256x256.png
SO /Users/marirodr/cursus/cub3d/textures/Metal_15-256x256.png
WE /Users/marirodr/cursus/cub3d/textures/Tile_08-256x256.png
EA /Users/marirodr/cursus/cub3d/textures/Wood_07-256x256.png

F 113,66,52
C 100,149,237	

11111111111111111111111111111
10000000010000000000000000001
10000000010000000000000000001
10000000010000000000000000001
11111111110000000000000000001
10000000000000000000000000001
10000000000000000000000000001
10N00000000000000000000000001
10000000000000000000000000001
11111111111111111111111111111