NO ./textures/Brick_02-256x256.png
SO ./textures/Metal_15-256x256.png
WE ./textures/Tile_08-256x256.png
EA ./textures/Wood_07-256x256.png

F 220,100,200
C 225,30,0

11111111111
1000000001
10000000011
1000000001
1111111111111
10000000E1
1111111111111111