NO ./textures2/txt_n.png
SO ./textures2/txt_s.png
WE ./textures2/txt_w.png
EA ./textures2/txt_e.png
F 113,66,52
C 100,149,237

11111111111
11111011111
10000000001
10000N00001
10000000001
10000000001
10000000001
10000000001
11110000001
11111111111
