NO ./textures/Brick_02-256x256.png
WE ./textures/Tile_08-256x256.png
SO ./textures/Metal_15-256x256.png      
EA ./textures/Wood_07-256x256.png

F 0,0
C 225,30,0

111111
100001
111111