NO /Users/marirodr/cursus/cub3d/textures/redbrick.png
SO /Users/marirodr/cursus/cub3d/textures/bluestone.png
WE /Users/marirodr/cursus/cub3d/textures/greystone.png
EA /Users/marirodr/cursus/cub3d/textures/purplestone.png

F 100,149,237
C 225,30,0

11111111111
10000000001
10000000001
10000W00001
10000000001
10000000001
10000000001
11110000001
11111111111
