NO /Users/erivero-/Desktop/cube/textures/redbrick.png
SO /Users/erivero-/Desktop/cube/textures/bluestone.png
WE /Users/erivero-/Desktop/cube/textures/greystone.png
EA /Users/erivero-/Desktop/cube/textures/purplestone.png

F 100,149,237
C 225,30,0

11111111111
11111011111
10000000001
10000N00001
10000000001
10000000001
10000000001
10000000001
11110000001
11111111111
