NO no 
SO so
WE we 
EA ea
F 333
C 222

111111
100001
111111