NO /Users/marirodr/cursus/cub3d/textures/Brick_02-256x256.png
SO /Users/marirodr/cursus/cub3d/textures/Metal_15-256x256.png
WE /Users/marirodr/cursus/cub3d/textures/Tile_08-256x256.png
EA /Users/marirodr/cursus/cub3d/textures/Wood_07-256x256.png

F 220,100,0
C 225,30,0

        1111111111111111111111111
        1000000000110000000000001
        1011000001110000000000001
        1001000000000000000000001
111111111011000001110000000000001
100000000011000000000111111111111
11110111111111011100000010001
11110111111111011101010010001
11000000110101011100000010001
10000000100000001100000010001
10000001 10000001101010010001
11000001110101011111011110N0111111 111
11110111 1110101 101111010001
11111111 1111111 111111111111